4 4 4 4 4 4 4 4 4 4 4 4 4 4 4 4 4 4 4 4 4 4 4 4 4 4 4 4 4 4 4 4 4 4 4 4 4 4 4 4 4 4 4 4 4 4 4 4 4 4
4 4 4 4 4 4 4 4 10 4 4 4 4 4 4 4 4 4 4 4 4 4 4 4 4 4 4 4 4 4 4 4 4 4 4 4 4 4 4 4 4 4 4 4 4 4 4 4 4 4
4 4 4 4 4 4 4 4 4 4 4 4 4 4 4 4 4 4 4 4 4 4 4 4 4 4 4 4 4 4 4 4 4 10 4 4 4 4 4 4 4 4 4 4 4 4 4 4 4 4
4 4 4 4 4 4 4 4 4 4 4 4 4 4 4 4 4 24 4 4 4 4 4 4 4 4 4 4 4 4 4 4 4 4 4 4 4 4 4 4 4 4 4 4 4 4 4 4 4 4
4 4 4 4 4 4 4 4 4 4 4 4 4 4 4 4 4 4 4 4 4 4 4 4 4 4 4 4 4 4 4 4 4 4 4 4 4 4 4 4 4 4 4 4 4 4 4 4 4 4
4 4 11 4 4 4 4 8 8 8 8 8 8 8 4 4 4 4 4 8 8 8 8 8 8 8 8 8 8 8 8 4 8 8 8 8 8 8 8 8 8 4 4 4 4 4 4 4 4 4
4 4 4 4 4 4 4 8 15 19 0 19 15 8 4 4 4 4 4 8 23 20 23 23 21 23 23 23 15 15 8 4 8 0 0 12 0 12 0 0 8 4 4 4 4 4 4 4 4 4
4 4 4 9 4 4 4 8 0 0 0 0 0 8 4 4 4 4 4 8 23 23 23 23 22 23 23 23 23 23 8 4 8 16 0 14 0 0 0 17 8 4 4 4 4 4 4 4 4 4
4 4 4 4 4 4 4 8 0 0 0 0 0 8 4 4 4 4 4 8 23 23 23 23 23 23 23 23 23 23 8 4 8 16 13 0 0 0 0 17 8 4 4 4 4 4 4 4 4 4
4 4 4 4 4 4 4 8 0 0 0 0 0 8 4 4 4 4 4 8 23 23 23 23 23 23 23 23 23 23 8 4 8 16 0 0 0 0 14 17 8 4 4 4 4 4 4 4 4 4
4 4 4 4 4 4 4 8 15 0 0 0 15 8 4 4 4 4 4 8 8 8 8 23 8 8 8 8 8 8 8 4 8 16 0 0 0 0 14 17 8 4 4 4 4 4 4 4 4 4
4 4 4 4 4 4 4 8 0 0 0 0 0 8 4 4 4 4 4 4 4 4 8 0 0 8 4 4 4 4 4 4 8 16 13 0 0 0 0 17 8 4 4 4 4 4 4 9 4 4
4 4 4 4 4 4 4 8 8 8 0 8 8 8 4 4 11 4 4 4 4 4 8 0 0 8 4 4 4 4 4 4 8 16 0 0 0 0 0 17 8 4 4 4 4 4 4 4 4 4
4 4 4 4 4 4 4 4 4 8 0 8 4 4 4 4 4 4 4 9 4 4 8 0 0 8 4 4 4 4 4 4 8 0 0 0 0 0 0 0 8 4 4 4 4 4 4 4 4 4
4 4 4 4 4 4 4 4 4 8 0 8 4 4 4 4 4 4 4 4 4 4 8 0 0 8 4 4 4 10 4 4 8 8 8 8 8 8 0 8 8 4 4 4 4 4 4 4 4 4
4 4 4 4 4 4 4 8 8 8 0 8 4 4 8 8 8 8 8 8 8 8 8 0 0 8 4 4 4 4 4 4 4 4 4 4 4 8 0 8 4 4 4 4 4 4 4 4 4 4
4 4 4 4 4 4 4 8 0 0 0 8 4 4 8 0 0 0 0 0 0 0 0 0 0 8 4 4 4 4 4 4 4 4 4 4 4 8 0 8 4 4 4 4 4 4 4 4 4 4
4 4 4 4 4 4 4 8 0 8 8 8 4 4 8 0 0 0 0 0 0 0 0 0 0 8 8 8 8 8 8 4 4 4 4 8 8 8 0 8 4 4 4 4 4 4 4 4 4 4
4 4 4 4 4 4 4 8 0 8 4 4 4 4 8 0 0 0 0 0 0 0 0 0 0 0 0 0 0 0 8 4 4 4 4 8 0 0 0 8 4 4 4 4 4 4 4 4 4 4
4 4 4 4 4 4 4 8 0 8 8 8 8 8 8 0 0 0 0 0 0 0 0 0 0 0 0 0 0 0 8 4 4 4 4 8 0 0 0 8 4 4 4 4 4 4 4 4 4 4
4 4 4 4 4 4 4 8 0 8 8 0 0 0 0 0 0 0 0 0 0 0 0 0 0 0 0 0 0 0 8 8 8 8 8 8 0 0 0 8 4 4 4 4 4 4 4 4 4 4
4 4 4 9 4 4 4 8 0 8 8 0 0 0 0 0 0 0 0 0 0 0 0 0 0 0 0 0 0 0 0 0 0 0 0 0 0 0 0 8 4 4 4 4 4 10 4 4 4 4
4 4 4 4 4 4 4 8 0 8 8 0 0 8 8 8 8 8 0 0 0 0 0 0 0 0 0 0 0 0 0 0 0 0 0 0 0 0 0 8 4 4 4 4 4 4 4 4 4 4
4 4 4 4 4 4 4 8 0 8 8 0 0 8 4 4 4 8 0 0 0 0 0 0 0 0 0 0 0 0 8 8 8 8 8 0 0 0 0 8 4 4 4 4 4 4 4 4 4 4
4 4 4 4 4 4 4 8 0 8 8 0 0 8 8 8 4 8 0 0 0 0 0 0 0 0 0 0 0 0 8 4 4 4 8 0 0 0 0 8 4 4 4 4 4 4 4 4 4 4
4 4 4 4 4 4 4 8 0 8 8 0 0 0 0 8 4 8 8 8 8 8 8 0 0 8 8 8 8 8 8 4 4 4 8 0 0 0 0 8 4 4 4 4 4 4 4 4 4 4
4 4 4 4 4 4 4 8 0 8 8 8 8 8 0 8 4 4 4 4 4 4 8 0 0 8 4 4 4 4 4 4 4 4 8 0 0 0 0 8 4 4 4 4 4 4 4 4 4 4
4 4 4 4 4 4 4 8 0 8 4 4 4 8 0 8 4 4 4 4 4 4 8 0 0 8 4 4 4 4 4 4 4 4 8 0 0 0 0 8 4 4 4 4 4 4 4 4 4 4
4 4 4 4 10 4 4 8 0 8 8 8 8 8 0 8 4 4 4 4 4 4 8 0 0 8 4 4 4 4 4 4 4 4 8 0 0 0 0 8 4 4 4 4 4 4 4 4 4 4
4 4 4 4 4 4 4 8 0 0 0 0 0 0 0 8 4 4 10 4 4 4 8 0 0 8 4 4 4 4 4 4 4 4 8 0 0 0 0 8 4 4 4 4 9 4 4 4 4 4
4 4 4 24 4 4 4 8 0 0 0 0 0 0 0 8 4 4 4 4 4 4 8 0 0 8 4 4 4 4 4 4 4 4 8 0 0 0 0 8 4 4 4 4 4 4 4 4 4 4
4 4 4 4 4 4 4 8 0 0 0 0 0 0 0 8 4 4 4 4 4 4 8 0 0 8 4 4 4 4 4 4 4 4 8 0 0 0 0 8 4 4 4 4 4 4 4 4 4 4
4 4 4 4 4 4 4 8 0 0 0 0 0 0 0 8 4 4 4 4 4 4 8 0 0 8 4 4 4 4 4 4 4 4 8 0 0 0 0 8 4 4 4 4 4 4 4 4 4 4
4 4 4 4 4 4 4 8 0 0 0 0 0 0 0 8 4 4 4 4 4 4 8 0 0 8 4 4 4 4 4 4 4 4 8 0 0 0 0 8 4 4 4 4 4 4 10 4 4 4
4 4 4 4 4 4 4 8 0 0 0 0 0 0 0 8 4 4 4 4 4 4 8 0 0 8 4 4 4 4 4 4 4 4 8 0 0 0 0 8 4 4 4 4 4 4 4 4 4 4
4 4 4 4 4 4 4 8 8 8 8 8 8 8 8 8 4 4 8 8 8 8 8 0 0 8 8 8 4 4 4 4 4 8 8 0 0 0 0 8 4 4 4 4 4 4 4 4 4 4
4 4 4 4 4 4 4 4 4 4 4 4 4 4 4 4 4 8 8 0 0 0 0 0 0 0 0 8 8 4 4 4 8 8 0 0 0 0 0 8 4 4 4 4 4 4 4 4 4 4
4 4 10 4 4 4 4 8 8 8 8 8 8 8 8 8 8 8 0 0 0 0 0 0 0 0 0 0 8 8 8 8 8 0 0 0 0 0 0 8 4 4 4 4 4 4 4 4 4 4
4 4 4 4 4 4 4 8 0 0 0 0 0 0 0 0 0 0 0 0 0 0 0 0 0 0 0 0 0 0 0 0 0 0 0 0 0 0 0 8 4 4 4 4 4 4 4 4 4 4
4 4 4 4 4 4 4 8 0 0 0 0 0 0 0 0 0 0 0 0 0 0 0 0 0 0 0 0 0 0 0 0 0 0 0 0 0 0 0 8 4 4 24 4 4 4 4 4 4 4
4 4 4 4 4 4 4 8 0 0 0 0 0 0 0 0 0 8 0 0 0 0 0 0 0 0 0 0 0 0 0 0 0 0 0 0 0 0 0 8 4 4 4 4 4 4 4 4 4 4
4 4 4 4 4 4 4 8 0 0 0 0 0 0 0 0 0 8 0 0 0 0 0 0 0 0 0 8 8 8 8 0 0 0 0 0 0 0 0 8 4 4 4 4 4 4 4 4 4 4
4 4 4 4 4 4 4 8 0 0 0 0 0 0 0 0 0 8 0 0 0 0 0 0 0 0 0 8 4 4 8 0 0 0 0 0 0 0 0 8 4 4 4 4 4 11 4 4 4 4
4 4 4 4 4 4 4 8 0 0 0 0 0 0 0 0 0 8 8 8 8 8 8 8 8 8 8 8 4 4 8 0 0 0 0 0 0 0 0 8 4 4 4 4 4 4 4 4 4 4
4 4 4 4 4 4 4 8 8 8 8 8 8 8 8 8 8 8 4 4 4 4 4 4 4 4 4 4 4 4 8 8 8 8 8 8 8 8 8 8 4 4 4 4 4 4 4 4 4 4
4 4 4 4 4 4 4 4 4 4 4 4 4 4 4 4 4 4 4 4 4 4 4 4 4 4 4 4 4 4 4 4 4 4 4 4 4 4 4 4 4 4 4 4 4 4 4 4 4 4
4 4 4 4 4 4 4 4 4 4 4 4 4 4 4 4 4 4 4 4 4 4 4 4 4 4 4 4 4 4 4 4 4 4 4 4 4 4 4 4 4 4 4 4 4 4 4 4 4 4
4 4 4 9 4 4 4 4 4 4 4 10 4 4 4 4 4 4 4 4 4 4 4 4 4 4 4 4 4 4 4 4 4 4 4 4 4 4 4 4 4 4 4 4 4 4 4 4 4 4
4 4 4 4 4 4 4 4 4 4 4 4 4 4 4 4 4 4 4 4 4 4 4 4 4 4 10 4 4 4 4 4 4 4 4 4 4 4 4 4 4 4 4 4 4 4 4 4 4 4
4 4 4 4 4 4 4 4 4 4 4 4 4 4 4 4 4 4 4 4 4 4 4 4 4 4 4 4 4 4 4 4 4 4 4 4 4 4 4 4 4 4 4 4 4 4 4 4 4 4




